0024200000
0010000000
0023456200
0000000000
0000000000
0000000000
0000000000
0000000110
0000000001
0000000010
