0002222000
0011000000
1000000000
1110000000
0000000000
0000000000
0000000000
0000000000
0000000000
0000000000
