0200000000
2020000000
0200000000
0000000000
0000000000
0000000000
0000000000
0000000110
0000000001
0000000010
