0200000000
0010000000
0000000000
0000000000
0000000000
0000000000
0000000000
0000000110
0000000001
0000000010
