0300220000
0000000000
0000000000
0000000000
0000000000
0000000000
0000000000
0000000110
0000000001
0000000010
