0200000000
0210000020
0000000000
0000000000
0000000000
0000000000
0000000000
0000000100
0200001020
0000000000
