0002200000
0210000020
0000000000
0000000000
0001000000
0010100000
0010100000
0010111110
0410000561
0001111011
