6000000000
0211000020
0002200000
1110000000
0000000000
0000000000
0000000000
0000000000
0200000020
0000000000
