4000000000
2011000000
0000000000
1110000000
0000000000
0000000000
0000000000
0000000000
0000000000
0000000000
