0200000000
0010000000
0000000000
0000000000
0000000000
0000000000
0000000000
0000000101
0000001000
0000000101
