0002200000
0010000000
0000000000
0000000000
0001000000
0010100000
0010100000
0010111110
0010000001
0001111011
